#########.##########
#F.............B...#
#.#.#.#.#.#.###.#...
#.#.#.#.#.#........#
#....##.#.#.#.###..#
#.#...#.....#...#P.#
#.###.#.###.#.###..#
#.F.......#.#....F.#
#######.#.#.########
#.....#.#.#.#......#
#.###.#.#.#.#.###..#
#.#...#...#...#....#
#.#.#.#####.#.#.#..#
#...#.......#...#..#
#####.#######.######
#.......F..........#
#.###############..#
#...F..............#
#..................#
####################