####################
........#..........#
#.#.#.#.#@#.###.#...
#.#...###.#.#...#..#
#.o.###.#.#.#.###..#
#.#...#.....#...#O.#
#.###.#.###.#.###..#
#.....#...#.#....@.#
#######.#.#.########
#.....#.#.#.#......#
#.###.#.#.#.#.###..#
#.#...#...#...#....#
#.#.#.#####.#.#.#..#
#...#.......#...#..#
#####.#######.######
#.......@..........#
#.###############..#
#...@..............#
#..................#
####################
