#########.##########
#..@...........o...#
#.#.#.#.#.#.###.#...
#.#.#.#.#.#.#...#..#
#....##.#.#.#.###..#
#.#...#.....#...#O.#
#.###.#.###.#.###..#
#.@.......#.#....@.#
#######.#.#.########
#.....#.#.#.#......#
#.###.#.#.#.#.###..#
#.#...#...#...#....#
#.#.#.#####.#.#.#..#
#...#.......#...#..#
#####.#######.######
#.......@..........#
#.###############..#
#...@..............#
#..................#
####################
