####################
........#..........#
#.###.#.#@#.###.#...
#.#...#.#.#.#...#..#
#.#.###.#.#.#.###..#
#o#...#.....#...#O.#
#.###.#.###.#.###..#
#.....#...#.#....@.#
#######.#.#.########
#.....#.#.#.#......#
#.###.#.#.#.#.###..#
#.#...#...#...#....#
#.#.#.#####.#.#.#..#
#...#.......#...#..#
#####.#######.######
#.......@..........#
#.###############..#
#...@..............#
#..................#
####################
