####################
#..................#
#.#.#.#.#.#.###.#..#
#.#.#.#.#.#........#
....#.#.#.#.#.###..#
#.....#.....#...#..#
#####.#.###.########
#.........#.#......#
#######.#.#.#.####.#
#....P#.#.#.#B#....#
#.#####.#.#.#.###..#
#.#...#...#...#....#
#.#.#.#########.#..#
#...#.......#...#..#
#####.#######.######
#..................#
####.###########...#
#..................#
...................#
####################