####################
#FFFFFFFFFFFFFFFFFF#
#.......FFF........#
#.......B.P........#
#..................#
#..................#
#..................#
#..................#
#..................#
#..................#
#..................#
#..................#
#..................#
#..................#
#..................#
#..................#
#..................#
#..................#
#..................#
########.#.#########