####################
#FFFFFFFFFFFFFFFFFF#
#..................#
#..................#
#.......B.P........#
#..................#
#..................#
#..................#
#..................#
#..................#
#..................#
#..................#
#..................#
#..................#
#..................#
#..................#
#..................#
#..................#
#..................#
########.#.#########